----------------------   陈羽凡背绿腰包回应白百何出轨：蛋疼的回家过节吧   -------------------------
comment = 每当看到哪个明星又分手了，一堆人评论:心疼……一天到晚心疼陈羽凡，心疼丫丫，心疼王宝强，一群刚能吃饱饭的去心疼人家年收入上亿的富豪，你有啥资格心疼人家啊？人家有名气，有钱，你啥也没有，恋爱也没谈过，天天大门不出二门不迈的，抱个破手机就心疼了。还是先疼下自己吧！,	pos = 11,	neg = 2,	total = 9
comment = 陈羽凡让白百何红了，白百何让陈羽凡绿了，一段感情就这么黄了。出轨队又得一分，吸毒队和嫖娼队要加油啊！作为近几年最受争议的三个传奇女性，给大家表演个节目吧。白百何 姚笛 马蓉 预备唱：白姚马 腚朝西 驼着王宝强 文章和助理 明星取精很容易 一取就是几万亿 什么冰火鲜肉什么文章助理 什么国外宾馆什么泳池飞机。,	pos = 4.0,	neg = 4.0,	total = 0.0
comment = 看到这次的评论，竟然有一半的评论觉得出轨关你什么事。因为对于出轨这件事，大家已经开始麻木了。下一次，再有明星出轨婚外情啊之类，应该就是全民骂媒体干嘛要爆料出来，出轨的人根本就是被害者之类的吧。这就是公众人物的影响力，把大家的三观都扭转了,	pos = 1,	neg = 8,	total = -7
comment = 其实因感情不合而离婚倒很正常，离婚后再恋爱大家也无可厚非，但是婚内出轨的行为不管是明星还是百姓，都是应该被唾弃的，作为公众人物，肩负着宣传正能量的责任和义务，就跟应该严格约束自己。,	pos = 9.0,	neg = 7.0,	total = 2.0
comment = 白百何和马蓉正式成立组合了，取名白蓉马，走上取精之路。,	pos = 2,	neg = 0,	total = 2
comment = 她是演员，可能还是是很多人的标杆，不管认不认她都是公众人物，不管是不是公众人物，出轨错了就是错了！她出轨和很多看客没有关系？也许她就影响着身边差不多的影迷也包括一些孩子。没有感情可以离婚再谈恋爱，可是她还不是为了利益才选择隐瞒而导致今天的？,	pos = 7.8125,	neg = 10.5,	total = -2.6875
comment = 羽哥的意思很明确 我们都曾经做过对不起对方的事……所以 选个绿包 来以此证明 只要顶不绿 包没关系……,	pos = 3.5,	neg = 1.0,	total = 2.5
comment = 我喜欢百何的电影，羽凡的音乐，刚好这事与电影和音乐都无关。,	pos = 4.0,	neg = 2.0,	total = 2.0
comment = 这两夫妻说不定早离了，不合适离婚并没什么，但明明离了还欺骗大众天天秀恩爱就是人品问题了。虽然他们确实与我们无关，但作为公众人物你起码得是个正面人物，更要学会尊重大家,	pos = 12.671875,	neg = 3.25,	total = 9.421875
comment = 一个观众的修养？更重要的是艺人修养吧！赚着观众的钱还整天净整些没用的负能量！,	pos = 8.3125,	neg = 4.8125,	total = 3.5
comment = 陈羽凡让野白合红了，野白合让陈羽凡绿了，一段感情黄了……,	pos = 0,	neg = 0,	total = 0
comment = 以前就知道白百合演的电影好看，不知道她叫什么名字，现在知道了，这广告打的值。,	pos = 3,	neg = 1,	total = 2
comment = 二十年前罗大佑专门为此事写下不朽的歌谣，《野百合也有春天》,	pos = 2,	neg = 0,	total = 2
comment = 永远喜欢，人生的路上没有一个人是不做错事的。明星也是普通的人，也会做错事。在说了任何事都是两面的，任何错误也不应该一个人承担。,	pos = 3,	neg = 3,	total = 0
comment = 作为公众人物，她就是错了。拿着天价的报酬，人前装少女。骗得观众对她爱。人后却是欲女。,	pos = 2,	neg = 1,	total = 1
comment = 一个戏子玩玩鸭子，关你半毛钱的事。玩鸭子的费用还是你们进电影院帮忙凑的,	pos = 1,	neg = 0,	total = 1
comment = 如果已经离婚了就公布吧！如果还没离婚别那么骚吧！在大庭广众之下别干出那么龌龊的事！实在熬不住！回家去搞！別丢你儿子的脸。。。,	pos = 4.0,	neg = 8.3125,	total = -4.3125
comment = 这个沙发冷清得太讽刺～唉～娱乐圈～除了戏子～真正的的艺术家屈指可数啊～,	pos = 1.0,	neg = 3.0,	total = -2.0
comment = 我可以听陈羽凡的歌，更可以不看白百何的戏，出轨了没什么好说，尤其是女人！,	pos = 1,	neg = 1,	total = 0
comment = 陈羽凡还是很想的开的？就当自行车丢了？让别人骑一圈又送回来了？还能使？呵呵！想开点长寿？,	pos = 2,	neg = 0,	total = 2
comment = 自己的东西让人用过了，感觉没面子扔了，然后又从新选一个别人用过的东西，这样就觉得有面子多了😀😀😀这就叫真爱？,	pos = 1,	neg = 2,	total = -1
comment = 哎，看了陈羽凡发这照片有点这种意思：“你们关注他老婆这事的都是闲得蛋疼！闭嘴，都回去的些。”,	pos = 2.5,	neg = 0.0,	total = 2.5
comment = 娱乐圈是最肮脏的圈子！比如，张柏芝脱光了掰开给陈冠希拍照，现在跟没事人一样！在比如，关之琳和富豪往下面塞高尔夫球，拿不出来，半夜去医院，还塞两个！现在还是屏幕面前人五人六的装纯！你说他们得有多厚的脸皮啊！,	pos = 1.0,	neg = 7.0,	total = -6.0
comment = 这样的女人还要？真留来过节啊？娱乐圈人果然是够胸襟 绿了无所谓最主要是钱钱钱💰,	pos = 0,	neg = 2,	total = -2
comment = 这话应该说爆料者，关你们屌事呀，你们在七嘴八舌，我都没在乎你们在乎什么！好笑。,	pos = 5.0,	neg = 0.0,	total = 5.0
comment = 很正常啊，男人女人哪个人不是骚浪贱？只是遇没遇到让你露出狐狸尾巴的那个人。不要刻薄的只说别人的不是，有一天却自扇嘴巴。人生的路还长着呢，谁也看不到自己的明天，请各位嘴上留德。毕竟是人家的事与群众无关，看看热闹得了。,	pos = 5.5,	neg = 2.0,	total = 3.5
comment = 我来替楼主表达下意思，传统中国封建思想，好比1-男人赤膊女人怎么了就不能赤膊了嘛？你会赤膊吗？2-男人站路边尿尿了女人怎么了就不能路边尿尿吗？3-自己家里有男人和别的女人睡了你心里会想没撒吃亏的要是女人生被人家睡了至少你的心是沉重的，等等好多比方男女都无法平等有些思想跟深蒂固。仅代表个人看法不支持任何一方！,	pos = 12.0,	neg = 4.0,	total = 8.0
comment = 对呀，人家自己的事别人何必操心，都是闲的……再说人家的婚烟愿意怎么过就怎么过！桌啥来着你这真是没事闲的蛋疼！,	pos = 4,	neg = 4,	total = 0
comment = 哈哈、、人家说你们呢，蛋疼的，回家过节吧，人家两夫妻就喜欢这样。关你们啥事,	pos = 1,	neg = 1,	total = 0
comment = 作为公众人物，她就是错了。拿着天价的报酬，人前装少女。骗得观众对她爱。人后却是欲女。,	pos = 2,	neg = 1,	total = 1
comment = 人都有七情六欲，毕竟都是动物。有的人清洁挂的高高在上，可以出家了，何必在评论里说别人是非。蛋疼的，回家过节吧。,	pos = 1,	neg = 3,	total = -2
comment = 大神们你好，我是新来的，不懂规矩，我就想问，我是直接喷？还是排队喷？愚人节过了吧！今天几号啦！,	pos = 0,	neg = 1,	total = -1
comment = 喜欢文末的这段话，除了百合的戏和羽凡的歌，别的都与我们无关，与是非曲直无关的人又何谈他人的曲直是非，我喜欢百合的电影，羽凡的音乐，刚好这事与电影和音乐都无关。路人尽量消停点，毕竟百合并没有和你男票出轨，羽凡就算离婚了也应该娶不到各位头上，喜欢就支持，不喜欢也别冒充警察，一个观众的自我修养。,	pos = 12.0,	neg = 10.0,	total = 2.0
comment = 其实娱乐圈好多离婚的，为了利益没公开而已，像孙俪和邓超，大家都以为他俩很恩爱，都是假象，早就离了，没办法，为了利益必须得演啊，不然就名誉扫地，搞不好还会破产，为了继续圈钱而已。,	pos = 6.0,	neg = 5.0,	total = 1.0
comment = 第二个王宝强。只要把钱袋子扣紧了没事演艺圈找个老婆超过她的遍地都是。,	pos = 0,	neg = 2,	total = -2
comment = 这种事就跟美日自己划的那个封锁咱们的岛链一样，多过几次也就习惯了。。这年头谁还没看过别人家的老公老婆出轨啊，明星出轨多个啥啊？多看几次也就习惯了。。多大点屁事儿。,	pos = 5.25,	neg = 2.0,	total = 3.25
comment = 管人家一点破事干嘛！放下手机走出卫生间看看自已女人还在不在床上吧，不要让隔壁你姓王的朋友抱走了你都不知道。,	pos = 1.0,	neg = 1.0,	total = 0.0
comment = 好与不好跟每个人都无关！管理好自己才是真事！吵吵闹闹的音乐、搬搬的演技！干嘛那么激动！又不付钱！给予！省省力气吧！各吃各的饭吧！,	pos = 16.5,	neg = 4.0,	total = 12.5
comment = 羽凡已经很明确表示原谅百何或不在意百何的出轨行为，也非常明确表示各位看客不要围观，在这一对明星眼里只有永恒利益，没有永恒爱情，一旦离了，对小孩是伤害，更对财产分配问题会有严重分歧化，与其这样还不如各玩各的！😊,	pos = 11.0,	neg = 10.265625,	total = 0.734375
comment = 毕竟她是公众人物，所以跟我们有关系啊 不然她的电影不看了 什么广告牌商品全部买，你们说有没有关系,	pos = 0,	neg = 0,	total = 0
comment = 我从来不追星，遇到了，看看，好像，他们吃香的喝辣的，从来没关注我们面朝黄土背朝天的人，而我们这些人，自己家的油盐酱醋茶，都备不齐。。。想想，我们是不是，没事找事，不嫌事多。。。,	pos = 1,	neg = 1,	total = 0
comment = 娱乐圈混乱圈子，出轨很正常！多少没被潜规则过！都是二手货了，结婚10来年了换换口味，人家有钱玩得起，人家都不要脸，你们操那心干嘛！,	pos = 4.5,	neg = 4.0,	total = 0.5
comment = 无聊的脑残粉，有这时间好好工作，陪陪家人，做点有意义的事不好吗，成天看热闹不嫌事大，跟你有啥关系？人家少块肉还是掉块骨头了？中国最脑残的就是粉丝，一月不吃不喝省吃俭用吃泡面也得维护明星，给明星刷礼物,	pos = 4,	neg = 3,	total = 1
comment = 路人尽量消停点，毕竟百何并没有和你男票出轨，羽凡就算离婚了也应该娶不到各位头上，喜欢就支持，不喜欢也别冒充警察，一个观众的自我修养。,	pos = 7,	neg = 4,	total = 3
comment = 就想问下“卓伟”，你没有犯过错？你自己就真的超凡脱俗，不食人间烟火？人家两人的婚姻关你鸟事？“宁拆十座庙不毁一段姻缘”懂不懂啊？就烦这样的狗仔，拆散一对是一对，是吧？人家离了对你有什么好处？还是借题想出名？你不喜欢羽凡的歌？没看过百合的电影？还是出于羡慕嫉妒恨的私心呢？,	pos = 7,	neg = 5,	total = 2
comment = 哎，人家夫妻都无所谓，这些网友不知道在激动个啥。有这闲情，还不如回家苦力上班多挣钱，少让你未来老婆在别人那挨点炮。,	pos = 2.0,	neg = 3.0,	total = -1.0
comment = 这意思很明确啊:你们都闲得蛋疼，尼玛，我们早就离婚了，想跟哪个玩就跟哪个玩^O^,	pos = 1.5,	neg = 2.0,	total = -0.5
comment = 陈思诚、陈赫、刘恺威、林丹可以拍部电影,文章当导演,徐峥当出品人,白百合、王鸥、马蓉、张子萱、姚迪演女主角,陶喆和汪峰来唱主题曲,卓伟老师来当发行。,	pos = 1,	neg = 0,	total = 1
comment = 一群闲得蛋疼的玩意，别人出轨跟你们有半分钱关系啊！死了都跟我没关系！,	pos = 0.0,	neg = 13.0,	total = -13.0
comment = 为什么男人找小三就不说呢，而女人有点屁大的事就搞的好像犯了多大事似的，如果她老公对她好她会跟别的男人在一起吗，说不定人家两口早就离婚了呢,	pos = 1.5,	neg = 1.0,	total = 0.5
====================================================================
